RGGGGGGGGGGGGTTTGGGGGGGGGGGGGGGG
RGGGGGGGGGGGGTTTGGGGGGGGGGGGGGGG
RGGGGGGGGGGGGTTTGGGGGGGGGGGGGGGG
RGGGGGGGGGGGGTTTGGGGGGGGGGGGGGGG
RGGGGGGGGGGGGTTTGGGGGGGGGGGGGGGG
RGGGGGGGGGGGGTTTGGGGGGGGGGGGGGGG
RGGGGGGGGGGGTTTTGGGGGGGGGGGGGGGG
RGGGGGGGGGGGTTTTGGGGGGGGGGGGGGGG
RGGGGGGGGGGGTTTGGGGGGGGGGGGGGGGG
RGGGGGGGGGGGTTTGGGGGGGGGGGGGGGGG
RGGGGGGGGGGGTTTGGGGGGGGGGGGGGGGG
RGGGGGGGGGGGTTTGGGGGGGGGGGGGGGGG
RGGGGGGGGGGGTTTGGGGGGGGGGGGGGGGG
RGGGGGGGGGGGTTTGGGGGGGGGGGGGGGGG
RGGGGGGGGGGGTTTGGGGGGGGGGGGGGGGG
RGGGGGGGGGGGTTTGGGGGGGGGGGGGGGGR
RGGGGGGGGGSSTTTTGGGGGGGGGGGGGGGR
RGGGGGGGSSSSTTTTGGGGGSSSSSGGGGGR
SSSSSSSSSSSSSTTTSSSSSSSSSSSSSGGR
SSSSSSSSSSSSSTTTSSSSSSSSSSSSSGGR
SSSSSSSSSSSSSTTTSSSSSSSSSSSSSSSS
SSSSSSSSSSSSSTTTSSSSSSSSSSSSSSSS
SSSSSSSSSSSSSTTTSSSSSSSSSSSSSSSS
SSSSSSSSSSSSSTPTSSSSSSSSSSSSSSSS
