11111111111111111111111111111111
10000000000000000000000000000001
10000000000000000000000000000001
10000000000000000000000000000001
10000000000000000000000001000001
10000000000000000000000001000001
10000000000000000000000001000001
10000000000000000000000001000001
10000000000000000000000001000001
10000011111111111000000001000001
10000000000100000000000001000001
10000000000100000000000001000001
10000000000100000000000001000001
10000000000000000000000001000001
10000000000000000000000001000001
10000000000000000000000001000001
10000000000000000000000001000001
10000000000000000000000001000001
10000000000000000000000001000001
10000000000000000000000001000001
10000000000000000000000001000001
10000000000000000000000001000001
10000000000000000000000000000001
11111111111111111111111111111111
