RSSSSSSSSSSSSSSSSSSSSSSSSSSSSSSS
RSSSSSSSSSSSSSSSSSSSSSSSSSSSSSSS
RSSSSSSSSSSSSSSSSSSSSSSSSSSSSSSS
RSSSSSSSSSSSSSSSSSSSSSSSSSSSSSSS
RSSSSSSSSSSSSSSSSSSSSSSSSSSSSSSS
RSSSSSSSSSSSSSSSSSSSSSSSSSSSSSSS
RSSSSSSSSSSSSSSSSSSSSSSSSSSSSSSS
RSSSSSSSSSSSSSSSSSSSSSSSSSSSSSSS
RSSSSSSSSSSSSSSSSSSSSSSSSSSSSSSS
RSSSSSSSSSSSSSSSSSSSSSSSSSSSSSSS
RSSSSSSSSSSSSSSSSSSSSSSSSSSSSSSS
RSSSSSSSSSSSSSSSSSSSSSSSSSSSSSSS
RSSSSSSSSSSSSSSSSSSSSSSSSSSSSSSS
RSSSSSSSSSSSSSSSSSSSSSSSSSSSSSSS
RSSSSSSSSSSSSSSPSSSSSSSSSSSSSSSS
RSSSSSSSSSSSSSSSSSSSSSSSSSSSSSSR
RSSSSSSSSSOOOOSSSSSSSSSSSSSSSSSR
RSSSSSSSOOOOOOOSSSSSSOOOOOSSSSSR
OOOOOOOOOOOOOOOOOOOOOOOOOOOOOSSR
OOOOOOOOOOOOOOOOOOOOOOOOOOOOOSSR
OOOOOOOOOOOOOOOOOOOOOOOOOOOOOOOO
OOOOOOOOOOOOOOOOOOOOOOOOOOOOOOOO
OOOOOOOOOOOOOOOOOOOOOOOOOOOOOOOO
OOOOOOOOOOOOOOOOOOOOOOOOOOOOOOOO
